0110000010001001001001011001001010000100010001101000010101101010011001001010101000011011010110100000
0001010100101010011010000100100000101001001100000101010000000001000010010000000011000000000000001101
1010010101000001000001101001001101010010110101111101100101010110101101000101111001011010110101110101
0001001010011100011011000101101001001000010101000000110110101010000000010100000101010111001001000010
1010011010100001001010110100100110101010110000011010000000001000110101001011010101000010010100101110
0001000001010111011110000101001010100110000110100001011010110010010100100001011010011100100010100000
0100010101001000001001010000100000101000110001011111100111010101100101001010001001010010010101001010
1101101100100110111010100111010101001101010100000001001110010000011010110101010010111000100000100101
0010101010010100000010101001000010100101001010110110100100110101000000000001001000010010001101101000
0100001001000010110100000011101100101101010001101000101010000100101101011010111010101001111010000010
0011011011111000111011011001101010100000000110000110000000110011011101100100100001000010000001010100
0101010001000110010001011110001000001011010100101000101101000101001000101001010100101000101111001010
0100010101101001001010001001100011010100010110010010101111101000010101000010010011000111110000010001
0111010100000100010001100010110101000110100000101001000101011011000010010101010110110000110110111010
0000001010101011001010010100000000101001010110000010110000010011011101010101000000000110000101010000
0101100001000000101001000001011110110010001111011000001011001000100100001000010110101010101101010101
1000010100110110101010101010010001000100110110000101011010100011001001100011001000010001100000000010
0101101010101000101010010001100100010101000001010101010000011010101010010101010010101010010110101010
0010000000000101001000101010101010101000110110110010001011100000000001001001001101100010101100010100
1001101111010000010010000000000010000011000000001001010000010101011010101010110100011000000010100001
0010010000101110100111010101011001101000011011101100110101100010001000001010000011010010110101110110
1001001010000000101010110101101110110111110110010110001000010111011101110000101001000110001100100000
1010100101111010000000001000000000000000000000110001110101010010011000000101010101010001011001010110
0000101000000100101101110101010101101101010110000100000101010101000101110100000100010101100100000001
0110100110101010010101010010100100011100100011010011011000111001101000011001010101001010010101101100
1000010001000000100010000100101010101011011100100101000111011010100101000100110101100001010100010110
0110101100010101011000111001010010000000000001011001010001000000010011011110101000010101000001100010
0010000001010100000011000101000110101101101111010101101110101101001010000101001111110011010100001001
1011110110010101011000011000011001000010100000000000000000000010011011010000010000001000011010100110
0000000001010101000101101011000010101000101111101011010101010111000101010101000101100101000001001010
0101101010011000101000000000111000010110101000010100100100100111110000100101101000111101010110110000
1011100100100011000101101101001011000011010011010010010110110011011111011000010110000010010000000110
1011001111001010101000100101100100101101011010101000101001001100000000000101000001011001100101110001
0000011100011010001011011010110101010000000000000010000010101001010110101000101010000100011000010100
0101001001100100110000001000000000001101101111010101010100000101010010010101100101010010100010100110
0111010010010001001101100011011010100000010000110000101101011000101100110000010001010101001011010010
1000010111000101100000011000111010010111110110001010000000100011000010001110100101001001010000010100
0010110010010010011011001010010100100000000001100100101101001000010101110000011010110101111010100010
0100100101100111000000101001000010010101011010101110010000011011001000001111000000000000010001101010
0101010100011010010101011010010110100010001000010101010101010101011101101000111010101101001101011001
0010000101000000100100000100110001001001010011000000100010000000101000111010000101010100101000000100
0101010010010101001001101010001101010011001000111011010110101010000010000100111000010011010101010010
0001010100101010010100010000101000101100011010001100001001100110101001011010001010100100010010100101
0110010101000001000101001010010111000011100011110010101011001101001010111001010001001011010100010100
1000110010101011101000100111110000011000111000000101000000100000110110010010001011010000000001101010
0101000100010001011010010010000110110010001011010000011010101010000000100101011000000101110101001000
0001101010101010000011001000101001001101011010010101010101010100101101010000000010101010001010101011
0100010000000000101000100101010011101001010011001010000000000010100100000101010101100000100000001000
0010100101010101011010010111000111001010100101100010101010110110101010101110100101001010101011100011
0101001110001001000001100000010010100000011100110100010001001000111000100100010000111100100110001010
0100110101010010010110110110110110001011000001000010100101011111000101001010110110001110010101101010
0110010000110100100000010010001100111101111100101001010100001001011000100000001010110100100000010000
1001000110000010110101111010111010101000000110010010001101010100001101110101011001110101110101101010
0101101100110100011000010010000000000011010010101000111011100001110110111000100010100010110101000010
0100011001100101100101110101010101010110011001101010000001010100000010010101101100001000001000110110
0101100100010100010000001001001010001001001100000101010100000110101000100100000101100110101101101100
0101010101100010101010101010010000110101110001010100001001010001011010001001010000010001000101000010
0000000100010100100001000001001110000000010100100010100110010100010110100101010101100110110100101100
1101010001001110011010101010010000110110101001011010101001001101000001010011001100011000001101000010
0001001010100110100010011001001101010001100010010101000010010010011010001000101001000010101000010100
0101111000101000011000100011010010000100011001010100110100101001001000111101000101110100110110110011
0010000011001010110101111000110100110011110100000001000011101011011010001001010100001010000001000100
0110110100110010100000101010000010001000000010110111101000000000110110101101010110101000110111110001
1000010010000101101010001001010100110101010100101001010101010110000001000011100001010110100001010110
0010101110101000011010100110110010010011001010000010000010001000101010101011101010000100010100011010
0100000001100101000001010100001100100110110000101000101001010101001010000101001010110110101001000000
1010110110011011101010010001010010001000100101001010010010000100100101011000110000101000101010011010
0000010010110011001010100101001000100011011000100110111001111110110000100010001010101010001011000100
1010101000001000010000010010010010011000000101110001010110000101001011001010100100000111010000101010
0010101010100101101011001001001100100101010010110100000010110100010010011010101010101010100110010010
1100000100010110000000101010011010010000110100000010101100001101101010100111010001000000010010101010
0001010010111011010101010101000001011010001010110110100001110000000100001010001011110111001010000010
0100110100010000010100010100101011101010100010100100011100000101010001010001101011001000101100110110
1001000011001101011001000001000101000001101110010110110001101000100101101010000000101011010011111001
0100110110100010000100101100110000101010010000100010001100100110010100000000101010000000001000110101
0101100000101110101001100110101010011000101011001010111001001001001001101101010010110110100010000000
0000010110011000100101001010000101100010000100011011000100100011011101010010000101010110011010101010
1010110010100010101000100010110000010100101001100000011010010100001000000111101001000001000100101110
0010100100101110101101001110101011010010010101001010100010100101100101011010100100011011101101000001
0100010101001000100011101000001110101100100100101010001101010011001101000000101001010011001010010110
0110100110010101001001000110100000000011010001001001100000011000100010010110010111001000100011010100
1000010011000011100100110100101101101000010110100100101111000101001011001010110000100101101001001001
1110100101101101001101000010010101100110111000011101100000110100110000100001000110011000011010010101
1010110000010000010010101001000010001011010011000000011010010010100101101111101111100101000101000000
0000010101010101001010010010010110100000001001101010111001101110010010001001000110010010111000110101
1101010010101000100001011001010001001101011100010100010010000001100111100010010001000100000010010010
0000100100000010010100001010100100100010101110100001100100111100110010101000101010101011011010101100
1101010010101010100101010000010110101000100101010110010001100011011000011101000100000000000101000010
0001000101010001001001001011010010100101001001000111000100001000001011001000010001010110111101011000
0100110100000100111010011000100101001000010010010010011001100101010011010010101100111011000000000101
0101000110110011000001000101001000100101000110100101000101001010101000101010000010110000101110111000
0011011000010100011010101010101011010011010001010100011000100000001010000101011010000110000001000101
1100010101001010100000101010100000001000111010000010100101001011010101010100000110101100101010101010
0011000101010001001101100000011011010010110001110100010000101001000001001010110001000010101000100010
1000010110001010101001001101011010001010001100010011001101011010010110100001100110011001000110001000
1010101010101000000100100101000100100100100010100100010000000101010000010100010011000100110010100101
0001000000101011010010010100101110101001110110011111010101010001001011010111010100011001001011101110
1010110110011010010100100010010100100101110101000100010010001011101000100001001001000100010000010100
0010000100100001010010011010100010011000100000111001001101010101000101010101010110010010111101000001
1001010010011010010111000100001001000101110110000100110000000000110010000100100000100100010000101011
